||||||||||||||||||||
     |||||||      ||
||||    ||| ||| ||||
||||| ||        ||||
|        ||||||   ||
| |||||||||     | ||
|     |||   |||||  |
|||| ||   ||     |||
||||||  |    |||    
||||||||||||||||||||